11111111
100CCC01
1P000O01
10000E01
111111I1