1111111
1CC0001
11100P1
1E100C1
1111111