1111111
1CC0001
11100P1
1C100E1
1111111