11111
1001
1PC001
10000E1
1111111