11111111
10001101
1CC00E01
1P000001
10000E01
11111111