111111111111
1P0000CC00C1
1000000E0001
1000000000P1
111111111111