1111111111111
1MM10000000C1
10000111110S1
1P0011E000001
1111111111111