1111111111111111111111111111111111
1EM000000000000C00000C0000000S0001
1010010100100000101001000000010101
1010010010101010001001000000010101
1P0000000C00C000000000000000000SC1
1111111111111111111111111111111111